1111111111111
1010000000001
10000000000C1
100000000PME1
1111111111111
