1111111111111
1C0000000M0C1
1C11111111011
1C0000000P0E1
1111111111111
