1111111111111
10000000000C1
1011111111011
100000000PME1
1111111111111
