1111111111111
1000000000001
10111111110C1
100000000PME1
1111111111111
